#E#############
#     ##### ###
# ### ##### ###
##### ##### ###
#####       ###
## #### #######
##      #######
##### #####  ##
##### ###   ###
##    ### #####
## ###### #####
##        #####
## ############
##            X
###############
